NO textures/wall_1.xpm
SO textures/wall_2.xpm
WE textures/wall_3.xpm
EA textures/wall_4.xpm

F 184,113,39
C 51,198,227

   1111111111111111111111111111
  11000000001100000000000000001
  10010000011100000111100010001
  100100000000000001  100010001
1110110000011100000111100010001
1000000000000000000000000000011
100000000011000001111111111111
111101100011110111
   1011001111101 11111111111
1111000011010101110000000001
1000000000000000110000001011
10000000000000001101010010011
11110111100101000000000 W 001
10000000001111100000000   111
111000000001  1000010100011
  1111111111  111111111111


