NO textures/wall_1.xpm
SO textures/wall_2.xpm
WE textures/wall_3.xpm
EA textures/wall_4.xpm
F 184,113,39
C 51,198,227
11111111111111111111111111111
10200000001120000000000000001
10000000011100000000000010001
10N00000000000000000000010001
10110000011100000000000210001
10000000001100000111011110001
11110111111111011100000010001
11110111111111011101010010001
11000000112101011100000010001
10000000000000021100000010001
12000000000000001101010010001
11000000110101000000000001111
111101111101010000001010001
10000000021100000100000011111
10000000000000001000200001001
10000000001200010000000001001
10000000001101000020000000001
12000000002100000001210000001
11111111111111111111111111111
